**X*XX***X
*X*X****X*
*XXX*XX*X*
**X*XX**XX
**XXXX*XXX
**XX*****X
*XXXXX*X*X
*X*XX***X*
**X**XXXXX
**********
