*XXX****X*XX**X*XXXXX*X
!*XX***X**XX*X**X*X*XX*X
!*X*XX***X**X****XX**X*X
!**XX***XX****XXXXXXXXX*
!**X*X****XX*XX*X**X*X**
!*X*X*****X*XX***XX*XX**
!*XX**XX**XX*XXXX*XX**X*
!***XX*******XX***X*XXXX
!**XXXX*X*XXXXXXXXXXXXXX
!*XX*X*X**XXX*X***XX*X*X
!*XXX***X*XXXXXXX****XXX
!***********************
